....................................................................................................
................................................................###############################.....
...................#################################............#                             #.....
...................#                               #............#                             #.....
...................#                               #............#                    ^        #.....
...................#                               #............#                             #.....
...................#              ##################............#                             #.....
...................#              #.............................#                             #.....
....################              ##########.........#######################        ###########.....
....#                                      #.........#                                        #.....
....#                                      #.........#                                        #.....
....#                                      #.........#                                        #.....
....#                                      #.........#       ##################################.....
....#                                      #.........#       #......................................
....#############################          #.........#       #......................................
.........................#                 ###########       #......................................
.........................#                 #                 ##################################.....
...............###########                 #                                                  #.....
...............#                           #                                                  #.....
...............#                                                      #                       #.....
...............#                                                      #                       #.....
..............#                                                       #                       #.....
.###########..#                                                       #                       #.....
.#         ####                #################################      #########################.....
.#                             #.....................#                #.............................
.#                             #.....................#                #.............................
.#    _         ################.....................#                #.............................
.#              #....................................#                #.............................
.################....................................##################.............................
....................................................................................................
