....................................................................................................
.....##################################....................####################################.....
.....#                                #....................#                                  #.....
.....#      ^                         #....................#                                  #.....
.....#                                #....................#                                  #.....
.....#                                #....................#                                  #.....
.....#                                #....................#                                  #.....
.....#                                ######################                                  #.....
.....#                                                                                        #.....
.....############################                                ##############      ##########.....
................................#                                #............#      #..............
................................#                                #............#      #..............
................................#                                #............#      #..............
................................#                                #............#      #..............
................................#                                #............#      #..............
................................#                                #............#      #..............
................................#                                #............#      #..............
................................#                                #............#      #..............
................................#                                #............#      #..............
................................#                                #............#      #..............
.....############################                                ##############      ##########.....
.....#                                                                                        #.....
.....#                                ######################                                  #.....
.....#                                #....................#                                  #.....
.....#                                #....................#                                  #.....
.....#                                #....................#                                  #.....
.....#                                #....................#                           _      #.....
.....#                                #....................#                                  #.....
.....##################################....................####################################.....
....................................................................................................
