....................................................................................................
.......#############..........##########################################............................
.......#           ############                                        #....#################.......
.......#                                                               ######               #.......
.......#    ^                                                                               #.......
.......#           ############                                                             #.......
.......#           #..........#                  ##############                             #.......
.......#           #..........#                  #............#                             #.......
.......#############..........#                  #............#                             #.......
..............................#                  #............#                             #.......
..............................#                  #............#                             #.......
..............................####################............#                             #.......
..............................................................#                             #.......
..............................................................######################        #.......
...................................................................................#        #.......
...................................................................................#        #.......
......#############................................................................#        #.......
......#           #................................................................#        #.......
......#     _     #.................................................################        #.......
......#           #................#####################............#                       #.......
......#           #................#                   #............#                       #.......
......#           #................#                   #............#                       #.......
......#           ##################                   #............#                       #.......
......#                                                #............#                       #.......
......#                                                ##############                       #.......
......##############                                                                        #.......
...................#                                                                        #.......
...................##########################################################################.......
....................................................................................................
....................................................................................................
