....................................................................................................
................................................................###############################.....
...................#################################............#                             #.....
...................#                               #............#                             #.....
...................#                               #............#                    ^        #.....
...................#                               #............#                             #.....
...................#              ##################............#                             #.....
...................#              #.............................#                             #.....
....################              ##########.........############                             #.....
....#                                      #.........#                                        #.....
....#                                      #.........#                                        #.....
....#                                      #.........#                                        #.....
....#                                      #.........#       ##################################.....
....#                                      #.........#       #......................................
....######################                 #.........#       #......................................
.........................#                 ###########       #......................................
.........................#                                   ##################################.....
...............###########                                                                    #.....
...............#                                                                              #.....
...............#                                                                              #.....
...............#                                                                              #.....
..............#                                                                               #.....
.###########..#                                                                               #.....
.#         ####                #######################                #########################.....
.#                             #.....................#                #.............................
.#                             #.....................#                #.............................
.#    -         ################.....................#                #.............................
.#              #....................................#                #.............................
.################....................................##################.............................
....................................................................................................
