....................................................................................................
..#########....##########################################...........................................
..#       #....#                                        #............######################.........
..#  ^    ######                      ####              #######......#                    #.........
..#                                   #..#                    #......#                    #.........
..#       ######                      #..#                    #......#             _      #.........
..#########....#                      ####                    #......#                    #.........
...............#               #                              #......#                    #.........
...............#               #                              #......#                    #.........
...............#               #                              #......####     #############.........
...............#               #                              #.........#     #.....................
...............#               #                              #.........#     #.....................
...............#               #                              #.........#     #.....................
...............#####     ####################                 ###########     ######................
...................#     #..................#                 #                    #................
...................#     #..................#           #######                    #................
...................#     #..................#                                      #................
...................#     #..................#                                      #................
.........###########     #####..............#                                      #................
.........#                   #..............#                 #                    #................
.........#                   #..............#                 #                    #................
......####                   #..............#                 #                    #................
......#                   ####..............########################################................
......#                   #.........................................................................
...####                   #.........................................................................
...#                      #.........................................................................
...########################.........................................................................
....................................................................................................
....................................................................................................
....................................................................................................