....................................................................................................
....................................................................................................
.......###################################################..........................................
.......#                #                                #..........................................
.......#                #        #                       #.......########################...........
.......#       ^        #        #                       #.......#                      #...........
.......#                #        #                       #########                      #...........
.......#                #        #                                                      #...........
.......#     ############        #                                                      #...........
.......#                         #                                                      #...........
.......#                         #       #####           #########                      #...........
.......#                         #       #...#           #.......#                      #...........
.......#                                 #...#           #.......##########     #########...........
.......#                                 #...#           #................#     #...................
.......################     ##############...#############................#     #...................
......................#     #.............................................#     #...................
......................#     #................###########...################     ################....
......................#     #................#         #...#                                   #....
..............#########     ##########.......#         #...#      #                            #....
..............#                      #.......#         #...#      #                            #....
..............#                      #########         #####      #                            #....
..............#                                                   #                            #....
..............#                                                   #          #############     #....
..............#                                                   #          #                 #....
..............#                      #########                    #          #     _           #....
..............#                      #.......#                               #                 #....
..............########################.......#                               #                 #....
................................. ...........#                               #                 #....
... .........................................###################################################....
....................................................................................................
