....................................................................................................
...###########################################......................................................
...#                                         #..........##################################..........
...#                                         #..........#                                #..........
...#                                         ############                                #..........
...#                                                                                     #..........
...#                                                                                     #..........
...#                                                                                     #..........
...#                                                                                     #..........
...#                                         ############                                #..........
...#                                         #..........#                                #..........
...#########     #######################    ##..........################                 #..........
...........#     #.....................#    #..........................#                 #..........
...........#     #.....................#    ###############............#                 #..........
...........#     #.....................#                  #............#                 #..........
...........#     #.....................#                  #............#                 #..........
..##########     ##....................#                  #............#                 #..........
..#               #....................#                  #............#     #############..........
..#               #....................#                  #............#     #......................
..#               #....................#                  #............#     #......................
..#   _           #....................#                  #............#     #......................
..#               #....................###############    ##############     ###########............
..#               #..................................#                                 #............
..#################..................................#                                 #............
.....................................................#                                 #............
.....................................................#                            ^    #............
.....................................................#                                 #............
.....................................................#                                 #............
.....................................................###################################............
....................................................................................................
