....................................................................................................
.....##################################....................####################################.....
.....#                                #....................#                                  #.....
.....#    ^                           #....................#                                  #.....
.....#                                #....................#                                  #.....
.....#                                #....................#                                  #.....
.....#                                #....................#                                  #.....
.....#                                ######################                                  #.....
.....#                                                                                        #.....
.....############################                                ##############################.....
................................#                                #..................................
................................#                                #..................................
................................#                                #..................................
................................#                                #..................................
................................#                                #..................................
................................#                                #..................................
................................#                                #..................................
................................#                                #..................................
................................#                                #..................................
................................#                                #..................................
.....############################                                ##############################.....
.....#                                                                                        #.....
.....#                                ######################                                  #.....
.....#                                #....................#                                  #.....
.....#                                #....................#                                  #.....
.....#                                #....................#                                  #.....
.....#                                #....................#                             _    #.....
.....#                                #....................#                                  #.....
.....##################################....................####################################.....
....................................................................................................