....................................................................................................
....................................................................................................
......################################################..............................................
......#      #               #                       #..............................................
......#  _   #               #                       #..............................................
......#              #       #                       #..............................................
......#              #       #                       #..............................................
......#      #       #                               #..............................................
......#      #       #                               #..............................................
......########################################       ##########################################.....
......#                                              #             #                          #.....
......#                                              #             #                          #.....
......#                                              #             #                  ^       #.....
......#                                              #             #                          #.....
......#                                              #             #                          #.....
......#                                              #             #                          #.....
......#                                              #             #                          #.....
......#     ##########################################             ############               #.....
......#                                                            #                          #.....
......#                                                            #                          #.....
......#                                              #             #                          #.....
......#                                              #                                        #.....
......#                                              #                                        #.....
......#                                              #                                        #.....
......#                                              #                                        #.....
......#########################################################################################.....
....................................................................................................
....................................................................................................
....................................................................................................
....................................................................................................