....................................................................................................
....................................................................................................
.......###################################################..........................................
.......#                                                 #..........................................
.......#                                                 #.......########################...........
.......#     ^                                           #.......#                      #...........
.......#                                                 #########                      #...........
.......#                                                                                #...........
.......#                                                                                #...........
.......#                                                                                #...........
.......#                                                 #########                      #...........
.......#                                                 #.......#                      #...........
.......#                                                 #.......##########     #########...........
.......#                                                 #................#     #...................
.......################     ##############################................#     #...................
......................#     #.............................................#     #...................
......................#     #................##############################     ################....
......................#     #................#                                                 #....
..............#########     ##########.......#                                                 #....
..............#                      #.......#                                                 #....
..............#                      #########                                                 #....
..............#                                                                                #....
..............#                                                                                #....
..............#                                                                                #....
..............#                      #########                                          _      #....
..............#                      #.......#                                                 #....
..............########################.......#                                                 #....
................................. ...........#                                                 #....
... .........................................###################################################....
....................................................................................................