....................................................................................................
....................................................................................................
.......###################################################..........................................
.......#                #                                #..........................................
.......#                #                                #.......########################...........
.......#       ^        #                                #.......#                      #...........
.......#                #                                #########                      #...........
.......#                #                                                               #...........
.......#     ############                                                                    #...........
.......#                                                                                #...........
.......#                                                 #########                      #...........
.......#                                                 #.......#                      #...........
.......#                                                 #.......##########     #########...........
.......#                                                 #................#     #...................
.......################     ##############################................#     #...................
......................#     #.............................................#     #...................
......................#     #................##############################     ################....
......................#     #................#                                                 #....
..............#########     ##########.......#                                                 #....
..............#                      #.......#                                                 #....
..............#                      #########                                                 #....
..............#                                                                                #....
..............#                                                              #############     #....
..............#                                                              #                 #....
..............#                      #########                               #     _           #....
..............#                      #.......#                               #                 #....
..............########################.......#                               #                 #....
................................. ...........#                               #                 #....
... .........................................###################################################....
....................................................................................................
