....................................................................................................
....................................................................................................
......################################################..............................................
......#      #               #                       #..............................................
......#  _   #               #                       #..............................................
......#              #       #                       #..............................................
......#              #       #                       #..............................................
......#      #       #                               #..............................................
......#      #       #                               #..............................................
......########################################       ##########################################.....
......#                                              #                                        #.....
......#                                              #                                        #.....
......#                                              #                                ^       #.....
......#                                              #                                        #.....
......#                                              #                                        #.....
......#                                              #                                        #.....
......#                                              #                                        #.....
......#     ##########################################                                        #.....
......#                                                                                       #.....
......#                                                                                       #.....
......#                                              #                                        #.....
......#                                              #                                        #.....
......#                                              #                                        #.....
......#                                              #                                        #.....
......#                                              #                                        #.....
......#########################################################################################.....
....................................................................................................
....................................................................................................
....................................................................................................
....................................................................................................