....................................................................................................
....................................................................................................
.############################.......................................................................
.#                          #.............###################################################.......
.#                   -      #............##                                                 #.......
.#                          #...........##                                                  #.......
.#                          #..........##                                                   #.......
.#                          #.........##           ######################                   #.......
.#                          #........##            ##...................#                   #.......
.#          #################.......##              ##..................#                   #.......
.#          #.......................#                ##.................#                   #.......
.#          #.......................#                 #.................#                   #.......
.#          #.......................#                 #.................#                   #.......
.#          #.................#######                 #.................#                   #.......
.#          #.................#                       #.................#                   #.......
.#          #.................#                       #.................#                   #.......
.#          #.................#                       #................##                   #.......
.#          #.................#                       #...............##                    #.......
.#          #.................#                       #..............##            ##########.......
.#          #.................#                       #.............##            #.................
.#          ###################                       ##...........##            #..................
.#                                                     ##.........#             #...................
.#                                                      ##........#            #....................
.#                                                       #........#            #....................
.#                                                       #........#            #####################
.#                                                       #........#                                #
.#                                                       #........#                           ^    #
.#                                                       #........#                                #
.#########################################################........##################################
....................................................................................................
