....................................................................................................
.....################..###########################....#######################################.......
.....#              #..#                         #....#                                     #.......
.....#              #..#                         #....#                                     #.......
.....#              #..#               ######    #....#           ####                      #.......
.....#              #..#      ####     #....#    #....#           #..#        ######        #.......
.....#              #..#      #..#     #....#    #....#           #..#        #....#        #.......
.....#              #..#      #..#     #....#    ######           #..#        #....#        #.......
.....#      ####    ####      #..#     #....#                     ####        #....#        #.......
.....#      #..#              #..#     #....#           ######                #....#        #.......
.....#      #..#              #..#     #....#           #....#                ######        #.......
.....#      ####              #..#     ######           #....#                              #.......
.....#                        #..#                      #....#                              #.......
.....#                        #..#                      #....#                              #.......
.....#                        #..#                      #....#                              #.......
.....#   _                    #..#                      #....#       ######                 #.......
.....#                        #..#         ######       #....#       #....#                 #.......
.....#                        #..#         #....#       #....#       #....#                 #.......
.....#      ####              #..#         #....#       #....#       #....#      ####       #.......
.....#      #..#              #..#         #....#       #....#       #....#      #..#       #.......
.....#      #..#              #..#         #....#       ######       #....#      #..#       #.......
.....#      ####    ####      #..#         #....#                    #....#      ####       #.......
.....#              #..#      #..#         #....#                    #....#                 #.......
.....#              #..#      #..#         ######                    #....#                 #.......
.....#              #..#      ####              #                    #....#                 #.......
.....#              #..#                        #                    #....#                 #.......
.....#              #..#                        #                    #....#           ^     #.......
.....#              #..#                        #                    #....#                 #.......
.....################..###############################################....###################.......
....................................................................................................