....................................................................................................
.##################################################################################################.
.#               #                #                                                               #.
.#     _         #                #                                                               #.
.#               #                #       #                ########################################.
.#               #                #       #                                                 #     #.
.#               #                #       #                                                 #     #.
.#               #        #       #       #                                                 #     #.
.#               #        #       #       ############################################      #     #.
.#       #       #        #                                                 #        #      #     #.
.#       #       #        #                                                 #        #      #     #.
.#       #       #        #                                                 #        #      #     #.
.#       #       #        ############################################      #        #      #     #.
.#       #                                                   #       #      #        #            #.
.#       #                                                   #       #      #        #            #.
.#       #                                                   #       #      #                     #.
.#       ############################################        #       #      #               #     #.
.#                                                  #        #       #                      #     #.
.#                                                  #        #       #               #      #     #.
.#                                                  #        #                       #      #     #.
.#############################################      #                                #      #     #.
.#                                           #      #                                #      #     #.
.#                                           #      #                  ###############      #     #.
.#                                           #      ##########         #                    #     #.
.########################                                                                   #     #.
.#                                                                                          #  ^  #.
.#                                                                                          #     #.
.##################################################################################################.
....................................................................................................