....................................................................................................
.......#############..........##########################################............................
.......#           ############                                        #....#################.......
.......#                                                               ######               #.......
.......#    ^                                    #                                          #.......
.......#                                         #                                          #.......
.......#                                         ##############                             #.......
.......#           ############                  #............#                             #.......
.......#############..........#                  #............#                             #.......
..............................#                  #............#                             #.......
..............................#                  #............#                             #.......
..............................########      ######............#                             #.......
.....................................#      #.................#                             #.......
.....................................#      #.................######################        #.......
.....................................#      #............................#                  #.......
.....................................#      #............................#                  #.......
......#############..................#      #............................#                  #.......
......#           #..................#      #............................#                  #.......
......#     _     #..................#      #.......................######                  #.......
......#           #................###      ############............#              ######   #.......
......#           #................#                   #............#              #....#   #.......
......#           #................#                   #............#              #....#   #.......
......#           ##################                   ####################        ######   #.......
......#                                                                                     #.......
......#                                                                                     #.......
......##############                                                                        #.......
...................#                                                                        #.......
...................##########################################################################.......
....................................................................................................
....................................................................................................
