....................................................................................................
..............................................#######################...............................
..............................................#                     #...............................
..............................................#                     #...............................
..............................................#                     #...............................
.........##########################################        ##########...............................
.........#                                                          #...............................
.........#                                                          #...............................
.........#           #############                                  #...............................
.........#           #                                              #...............................
.........#      #    #               #####                          #...............................
.........#      #    #               #...#                          #...............................
.........#      ######               #...#                          #............##########.........
.........#                #######    #...#                          #............#        #.........
.........#                #          #...#           #              #............#    ^   #.........
.........#                #          #####           #              #............#        #.........
.........#                #                          #              ##############      ###.........
....######                #                          #              #                     #.........
....#                                                #              #                     #.........
....#                                                #              #                     #.........
....#        ########################       ###############     #####                     #.........
....#        #......................#                #                                    #.........
..###        #......................#                #                  #                 #.........
..#          #......................#                #                  #                 #.........
..#          #......................#                #                  #                 #.........
..# _  #######......................#######################################################.........
..#    #............................................................................................
..######............................................................................................
....................................................................................................
....................................................................................................