....................................................................................................
.#############.....................................................############.....................
.#           #.....................................................#          #.....................
.#  ^        #######################################################          #.....................
.#                                                                            #.....................
.#                                                                            #.....................
.#                                                                            #.....................
.#           ######################      ###########################          #.....................
.#           #....................#      #.........................#          #.....................
.####     ####.........############      ##############............####    ####.....................
....#     #............#                              #...............#    #........................
....#     #............#                              #...............#    #........................
....#     #..###########                              ############....#    #...###################..
....#     #..#                                                   #....#    #...#                 #..
....#     #..#                                                   #....#    #...#            _    #..
....#     #..#                                                   #....#    #...#                 #..
....#     ####                   #########                       ######    #...#                 #..
....#                            #.......#                                 #...#                 #..
....#                            #.......#                                 #...#                 #..
....#                            #.......#                                 #...#                 #..
....#                            #.......#                                 #...#                 #..
....#                            #.......#                                 #...#                 #..
....#     ####                   #########                        #####    #...#                 #..
....#     #..#                                                    #...#    #...#                 #..
....#     #..#                                                    #...#    #####                 #..
....#     #..#                                                    #...#                          #..
....#     #..###########                              #############...#                          #..
....#     #............#                              #...............#                          #..
....#     #............#                              #...............#    #####                 #..
....#######............################################...............######...###################..