................................................######..............................................
.............................................###      ###...........................................
..........................................###            ###........................................
.......................................###                  ###.....................................
....................................###                        ###..................................
.................................###                              ###...............................
..............................###                                    ###............................
...........................###                                          ###.........................
....#######################                                                #######################..
.......###       ^                                                                          ###.....
..........###                                                                            ###........
.............###                                                                      ###...........
................###                                                                ###..............
...................###                                                          ###.................
......................###                                                    ###....................
...................###                                                          ###.................
................###                                                                ###..............
.............###                                                                      ###...........
..........###                                                                            ###........
.......###                                                                          _       ###.....
....#######################                                                #######################..
...........................###                                          ###.........................
..............................###                                    ###............................
.................................###                              ###...............................
....................................###                        ###..................................
.......................................###                  ###.....................................
..........................................###            ###........................................
.............................................###      ###...........................................
................................................######..............................................
....................................................................................................