....................................................................................................
.......#############..........##########################################............................
.......#           ############                                        #....#################.......
.......#                                                               ######               #.......
.......#    ^                                    #                                          #.......
.......#           ############                  #                                          #.......
.......#           #..........#                  ##############                             #.......
.......#           #..........#                  #............#                             #.......
.......#############..........#                  #............#                             #.......
..............................#                  #............#                             #.......
..............................#                  #............#                             #.......
..............................####################............#                             #.......
..............................................................#                             #.......
..............................................................######################        #.......
...................................................................................#        #.......
...................................................................................#        #.......
......#############................................................................#        #.......
......#           #................................................................#        #.......
......#     _     #.................................................################        #.......
......#           #................#####################............#              #        #.......
......#           #................#                   #............#              #        #.......
......#           #................#                   #............#              #    #   #.......
......#           ##################                   ##############              ######   #.......
......#                                                                                     #.......
......#                                                                                     #.......
......##############                                                                        #.......
...................#                                                                        #.......
...................##########################################################################.......
....................................................................................................
....................................................................................................
