....................................................................................................
..............................................#######################...............................
..............................................#                     #...............................
..............................................#                     #...............................
..............................................#                     #...............................
.........######################################            ##########...............................
.........#                                                          #...............................
.........#                                                          #...............................
.........#                                                          #...............................
.........#                                                          #...............................
.........#                                                          #...............................
.........#                                                          #...............................
.........#                                                          #............##########.........
.........#                                                          #............#        #.........
.........#                                                          #............#    ^   #.........
.........#                                                          #............#        #.........
.........#                                                          ##############      ###.........
....######                                                          #                     #.........
....#                                                               #                     #.........
....#                                                               #                     #.........
....#        ########################       ###############     #####                     #.........
....#        #......................#                #                                    #.........
..###        #......................#                #                  #                 #.........
..#          #......................#                #                  #                 #.........
..#          #......................#                #                  #                 #.........
..# _  #######......................#######################################################.........
..#    #............................................................................................
..######............................................................................................
....................................................................................................
....................................................................................................