....................................................................................................
..#########....##########################################...........................................
..#       #....#                                        #............######################.........
..# ^     ######                                        #######......#                    #.........
..#                                                           #......#                    #.........
..#       ######                                              #......#             _      #.........
..#########....#                                              #......#                    #.........
...............#                                              #......#                    #.........
...............#                                              #......#                    #.........
...............#                                              #......####     #############.........
...............#                                              #.........#     #.....................
...............#                                              #.........#     #.....................
...............#                                              #.........#     #.....................
...............#####     ####################                 ###########     ######................
...................#     #..................#                                      #................
...................#     #..................#                                      #................
...................#     #..................#                                      #................
...................#     #..................#                                      #................
.........###########     #####..............#                                      #................
.........#                   #..............#                                      #................
.........#                   #..............#                                      #................
......####                   #..............#                                      #................
......#                   ####..............########################################................
......#                   #.........................................................................
...####                   #.........................................................................
...#                      #.........................................................................
...########################.........................................................................
....................................................................................................
....................................................................................................
....................................................................................................