.........................................##################.........................................
.........................................#                #.........................................
.........................................#                #.........................................
.........................................#                #.........................................
.........................................#                #.........................................
........................##################                ##################........................
........................#                                 #                #........................
........................#                                 #                #........................
........................#                                 #                #........................
........................#                                 #                #........................
........................#                                 #                #........................
.......###################################                #                ##################.......
.......#                                 #                                                  #.......
.......#                                 #                                                  #.......
.......#    _                            #                ##############                    #.......
.......#                                 #                #                                 #.......
.......#                                 #                #                                 #.......
.......##################                #                #                ##################.......
........................#                                 #                #........................
........................#                                 #                #........................
........................#                                 #                #........................
........................#                                 #        ^       #........................
........................#                                 #                #........................
........................##################                ##################........................
.........................................#                #.........................................
.........................................#                #.........................................
.........................................#                #.........................................
.........................................#                #.........................................
.........................................##################.........................................
....................................................................................................