................................................######..............................................
.............................................###      ###...........................................
..........................................###            ###........................................
.......................................###                  ###.....................................
....................................###                        ###..................................
.................................###                              ###...............................
..............................###                                    ###............................
...........................###                                          ###.........................
....#######################                       ##                       #######################..
.......###       ^                              ##..##                                      ###.....
..........###                                 ##......##                                 ###........
.............###                      ########..........##########                    ###...........
................###                     ##....................##                   ###..............
...................###                    ##................##                  ###.................
......................###                   ##............##                 ###....................
...................###                    ## ...............##                  ###.................
................###                     ##....................##                   ###..............
.............###                      ########..........##########                    ###...........
..........###                                 ##......##                                 ###........
.......###                                      ##..##                              _       ###.....
....#######################                       ##                       #######################..
...........................###                                          ###.........................
..............................###                                    ###............................
.................................###                              ###...............................
....................................###                        ###..................................
.......................................###                  ###.....................................
..........................................###            ###........................................
.............................................###      ###...........................................
................................................######..............................................
....................................................................................................